Initial level
8 8
++++++++
+      +
+      +
+      +
++W*+# +
+   +  +
+   ++++
+++++